R   1000         01080

NO ./path_to_the_north_texture

SO ./path_to_the_south_texture
WE ./path_to_the_west_texture
EA ./path_to_the_east_texture

S ./path_to_the_sprite_texture
C 125,76, 89
F 120,130,123

       111111111111111111111111
       100000200000000010000001
       100000000000000000001111
    111100000000000N00000001
    100100000000000001000001
    101000011111111111011111
    101000010101010110001111
    1100010000000110000001
    101000000000000000001111
    111000010000000110000001
    100000010000000110001111
    100000011110111111111111
    111111111110111111111111
    100000000000000000000001
    111111011110111111111111111111111111111111111111111111111111
    111111011110111111111111
    100000000110110000010001
    100000000000110010010001
    100000000110110000011011
    101010000110000010000001
    100100000110110000011001
    100100001101100100100001
    100000000110110000010001
    111111111111111111111111
    111111111111111111111111