R 500 500

SO textures/minecraft/cobblestone.xpm
NO textures/minecraft/diamond_block.xpm
EA textures/minecraft/plank_birch.xpm
WE textures/minecraft/черешня.xpm

S textures/wolf/s_dog.xpm


C textures/c_sky2.xpm

F textures/minecraft/podzol_top.xpm

11111111111111111111111111111
10000000001100000000000000001
10110000011100022200000010001
10010000000000000000000010001
10110000011100000000000010001
1000000000110W000111011110001
11110111111111011100000010001
11110111111111011101010010001
11200000110101011100000010001
10000000000000001100000010001
10000000000000001101010010001
11200000110101011111011110001
11110111111101011111011110001
11111111111111111111111111111