R 960 1080
NO ./path_to_the_north_texture
SO ./path_to_the_south_texture
WE ./path_to_the_west_texture
EA ./path_to_the_east_texture

S ./path_to_the_sprite_texture
F 220,100,0
C 225,30,0

 1111111111
100000000001
100110011001
100100001001
100000000001
100001100001
10001W010001
100001100001
100000000001
100100001001
100110011001
100000W00001
 1111111111