R 960 01080

NO ./path_to_the_north_texture

SO ./path_to_the_south_texture
WE ./path_to_the_west_texture
EA ./path_to_the_east_texture

S ./path_to_the_sprite_texture
F  80,0,0
C  0,0,0

111111111111
100000000001
100110011001
100100001001
100000000001
100001100001
10001W010001
100001100001
100000000001
100100001001
100110011001
100000W00001
111111111111