R 960 01080

NO ./path_to_the_north_texture

SO ./path_to_the_south_texture
WE ./path_to_the_west_texture
EA ./path_to_the_east_texture

S ./path_to_the_sprite_texture
C 0,0,0
F 0,0,0

 111111111111
1000000000001
100110011001
100100001001
100000000001
100001100001
10001W010001
100001100001
100000000001
100100001001
100110011001
100000000001
111111111111
111111111111
111111111111
111111111111
111111111111
110000000001
111111111111
