R 1920 1080
NO ./path_to_the_north_texture
SO ./path_to_the_south_texture
WE ./path_to_the_west_texture
EA ./path_to_the_east_texture

S ./path_to_the_sprite_texture
F 220,100,0
C 225,30,0

        11111111111111111111111111111111111111111111111111
        10000000001100000000000000000000000000000000000001
        10110000011100000020000011111111111111111111100001
        1001000000000000000000001                   100001
111111111011000001110000000000001                   100001
1000000000110000011101111111111111111111111111111111111011
1111011111111101110000001000100000000000000000000000000001
1111011111111101010101001000100000000000000000000000000001
1100000011010101110010001000000000000000000000000000000001
1000200000000000000000001000000000000000000000000000000001
1000000000000000110101001000100000000000000000000000000001
11000001110101011111011110N0111111111111111111111111111111
11110111 1110101 101111010001000000000000000000000000001
11111111 1111111 111111111111111111111111111111111111111