R 1920 1080
NO ./path_to_the_north_texture
SO ./path_to_the_south_texture
WE ./path_to_the_west_texture
EA ./path_to_the_east_texture

S ./path_to_the_sprite_texture
F 220,100,0
C 225,30,0


11111111111111
100000100000011111
100100000000000001
100100111001111111
10000010000001
11111111111111

        1111111111111111111111111
        1000000000110000000000001
        1011000001110000002000001
        1001000000000000000000001
111111111011000001110000000000001
100000000011000001110111111111111
11110111111111011100000010001
11110111111111011101010010001
11000000110101011100100010001
10002000000000001100000010001
10000000000000001101010010001
11000001110101011111011110N0111
11110111 1110101 101111010001
11111111 1111111 111111111111

        11111111111111111111111111111111111111111111111111
        10000000001100000000000000000000000000000000000001
        10110000011100000020000011111111111111111111100001
        1001000000000000000000001                   100001
111111111011000001110000000000001                   100001
1000000000110000011101111111111111111111111111111111111011
1111011111111101110000001000100000000000000000000000000001
1111011111111101110101001000100000000000000000000000000001
1100000011010101110010001000000000000000000000000000000001
1000200000000000110000001000000000000000000000000000000001
1000000000000000110101001000100000000000000000000000000001
11000001110101011111011110N0111111111111111111111111111111
11110111 1110101 101111010001000000000000000000000000001
11111111 1111111 111111111111111111111111111111111111111


       1111111111111111111111111
       100000200000000010000001
       100000000000000000000111
    111100000000000N00000001
    100100000000000001000001
    101000011111111111011111
    101000010101010110001111
    101000010000000110000001
    101000000000000000001111
    101000010000000110000001
    100000010000000110001111
    100000011110111111111111
    111111111110111111111111
    100000000000000000000001
    1111110111101111111111101111
    111111011110111111111111
    100000000110110000010001
    100000000000110010010001
    100000000110110000011011
    101010000110000010000001
    100100000110110000011001
    100100001101100100100001
    100000000110110000010001
    111111111111111111111111