R       1600             400dfgdfgdfg
SO         textures/test.xpm
NO                textures/memes/cat2.xpm
EA          textures/memes/cat4.xpm
WE    textures/memes/cat3.xpm
S           textures/wolf/s_dog.xpm
C       0,     255,        0
F       255,        0,      0

               1 1 1 1 1 1 1 1 1 1 1 1 1 1 1 1 1 1 1 1 1 1 1 1 1 1 1 1 1
          1 1 1 11111111111111111111111
          11111110000000000000000000001
          100000011111111000000000001111
          10110000011100022200000010001
          10010000000000000000000010001
          101100000111000W0000000010001
          111110000011000001110111100011111
               11110112002111011100000010001
          111111111111200211010100100011111
          11200000110120021100000010001
          10000000000000000000000010001
          100000000000000000001010010001
          11200000110101011111011110001
           11110000111101011111011110001
               10001111111111111111111111
               100011111111
               12021
               10201
               11111





