R       1600             900
SO         textures/memes/cat1.xpm
NO                textures/memes/cat2.xpm
EA          textures/memes/cat4.xpm
WE    textures/memes/cat3.xpm
S           textures/wolf/s_dog.xpm
C textures/c_sky2.xpm

F textures/w_whitebrick.xpm

               1 1 1 1 1 1 1 1 1 1 1 1 1 1 1 1 1 1 1 1 1 1 1 1 1 1 1 1 1
          1 1 1 11111111111111111111111111 1
          11111110000000000000000000001
          100000011111111000000000001111
          10110000011100022200000010001
          10010000000000000000000010001
          1011000001110000000W000010001
          111110000011000001110111100011111
               11110112002111011100000010001
          111111111111200211010100100011111
          11200000110120021100000010001
          10000000000000000000000010001
          100000000000000000001010010001
          11200000110101011111011110001
           11110000111101011111011110001
               10001111111111111111111111
               100011111111
               12021
               10201
               11111