R 1200 900

SO textures/wolf/mossy.xpm
NO textures/wolf/redbrick.xpm
EA textures/wolf/wood.xpm
WE textures/wolf/bluestone.xpm

S textures/wolf/s_dog.xpm


C textures/c_sky2.xpm

F textures/w_whitebrick.xpm

1111111111111111111111111111
1000000000110000000000000001
1011000001110002220000010001
1001000000000000000000010001
1011000001110000000000010001
1000000000110W00011111110001
1111011111111101110000010001
1111011111111101110110010001
1120000011010101110000010001
1000000000000000110000010001
1000000000000000110110010001
1120000011010101111111110001
1111011111110101111111110001
1111111111111111111111111111