R 1200 900

SO textures/wolf/mossy.xpm
NO textures/wolf/redbrick.xpm
EA textures/wolf/wood.xpm
WE textures/wolf/bluestone.xpm

S textures/wolf/s_dog.xpm

C textures/c_sky2.xpm

F textures/w_whitebrick.xpm 

                                                                                                            11111111111111111
               1 1 1 1 1 1 1 1 1 1 1 1 1 1 1 1 1 1 1 1 1 1 1 1 1 1 1 1 1                                    12020202020202021
          1 1 1 11111111111111111111111                                                                     10000000000000001
          11111110000000000000000000001                                                                     10000000000000001
          100000011111111000000000001111                                                                    10000000000000001
          10110000011100022200000010001                                                                     10000000000000001
          10010000000000000000000010001                                                                     10000000000000001
          10110000011100000000000010001                                                                     10000000000000001
          1111100000110000011101111000111111111111111111111111111111111111111111111111111111111111111111111110000000000000001
               11110112002111011100000W00000000000000000000000000000000000000000000000000000000000000000000000000000000000001
          1111111111112002110101001000111111111111111111111111111111111111111111111111111111111111111111111110000000000000001
          11200000110120021100000010001                                                                     10000000000000001
          10000000000000000000000010001                                                                     11111111111111111
          100000000000000000001010010001
          11200000110101011111011110001
           11110000111101011111011110001
               10001111111111111111111111
               100011111111
               12021
               10201
               11111