111111111111111
100000000000001
100000011111111
100000000000001
100000011000001
100000011000001
100000000000001
100000000000001
100000001111111
100000001000001
100000001000001
100000000000001
100000001000001
100000001000001
100000001111001
111111111111111