R 1920 1080

SO textures/wolf/w_mossy.xpm
NO textures/wolf/w_redbrick.xpm
EA textures/wolf/w_wood.xpm
WE textures/wolf/w_bluestone.xpm

S textures/wolf/s_dog.xpm

C textures/c_sky2.xpm

F textures/f_whitebrick.xpm

11111111111111111111111111111
10000000001100000000000000001
10000000001100000000000000001
10000000001100000000000000001
10000000001100000000000000001
10110000011102220000000010001
10000000001100000000000000001
10010000000000000000000010001
10110000011100N00000000010001
10000000001100000111011110001
11110111111111011100000010001
11110111111111011101010010001
11200000110101011100000010001
10000000000000001100000010001
10000000000000001101010010001
11200000110101011111011110001
11110111111101011111011110001
11111111111111111111111111111